11111111111111111111111
10000000000000111100001
10000000000000000000001
11110000000000000111111
10000000000000000000001
10000000000000000000001
10000000111110000000001
11111111111111111111111
