NO ./walls_xpm/bloodWall2.xpm
SO ./walls_xpm/question.xpm
WE ./walls_xpm/helpMe.xpm
EA ./walls_xpm/bloodHands.xpm

F 206,206,206
C 141,11,11

        1111111111111111111111111
        1000000000110000000000001
        1011000001110000000000001
        1001000000000000000000001
111111111111111111111111111111111
 
 
 
 
 
11111111111111111111111111111
1000000000000000000D0D00D0001
11000001110101011111011110N0111
11110111 1110101 101111010001
11111111 1111111 111111111111
